1 1 1 1 1 1 1 1 1 1 1 1 1 1 1 1 1 1 1 1 1 1 1 1 1 1 1 1 1 1 1 1 1 1 1 1 1 1 1 1 1 1 1 1 1 1 1 1 1 1
1 0 0 0 0 0 0 0 0 0 0 0 0 0 0 0 0 0 0 0 0 0 0 0 0 0 0 0 0 0 0 0 0 0 0 0 0 0 0 0 0 0 0 0 0 0 0 0 0 1
1 0 0 0 0 0 0 0 0 0 0 0 0 0 0 0 0 0 0 0 0 0 0 0 0 0 0 0 0 0 0 0 0 0 0 0 0 0 0 0 0 0 0 0 0 0 0 0 0 1
1 0 0 0 0 0 6 0 0 0 0 0 0 0 0 0 0 0 0 0 0 0 0 0 0 0 0 0 0 0 0 0 0 0 0 0 0 0 0 0 0 0 0 7 0 0 0 0 0 1
1 0 0 0 0 0 0 0 0 0 0 0 0 0 0 0 0 0 0 0 0 0 0 1 1 1 1 0 0 0 0 0 0 0 0 0 0 0 0 0 0 0 0 0 0 0 0 0 0 1
1 0 0 0 0 0 0 0 0 0 0 0 0 0 0 0 0 0 0 0 0 0 1 1 0 0 1 1 0 0 0 0 0 0 0 0 0 0 0 0 0 0 0 0 0 0 0 0 0 1
1 0 0 5 0 0 0 0 0 0 0 0 0 0 0 0 0 0 0 0 0 1 1 0 D D 0 1 1 0 0 0 0 0 0 0 0 0 0 0 0 0 0 0 0 0 8 0 0 1
1 0 0 0 0 0 0 0 0 0 1 0 0 0 0 3 3 3 3 3 3 1 0 D D D D 0 1 4 4 4 4 4 4 0 0 0 0 1 0 0 0 0 0 0 0 0 0 1
1 0 0 0 0 0 0 0 D D 1 0 0 3 3 3 3 3 3 3 3 1 0 D D D D 0 1 4 4 4 4 4 4 4 4 0 0 1 D D 0 0 0 0 0 0 0 1
1 0 0 0 0 0 0 0 D D 1 3 3 3 3 3 3 3 0 0 0 1 1 0 D D 0 1 1 0 0 0 4 4 4 4 4 4 4 1 D D 0 0 0 0 0 0 0 1
1 0 0 0 0 0 0 1 1 1 1 3 3 3 3 3 3 0 0 0 0 0 1 1 0 0 1 1 0 0 0 0 0 4 4 4 4 4 4 1 1 1 1 0 0 0 0 0 0 1
1 0 0 0 0 0 0 0 3 3 3 3 3 3 3 0 0 0 0 0 0 0 0 1 0 0 1 0 0 0 0 0 0 0 0 4 4 4 4 4 4 4 0 0 0 0 0 0 0 1
1 0 0 0 0 0 0 3 3 3 3 3 3 3 0 0 0 0 0 0 0 0 0 0 0 0 0 0 0 0 0 0 0 0 0 0 4 4 4 4 4 4 4 0 0 0 0 0 0 1
1 0 0 0 0 0 3 3 3 3 3 3 3 0 0 0 0 0 0 0 0 0 0 0 0 0 0 0 0 0 0 0 0 0 0 0 0 4 4 4 4 4 4 4 0 0 0 0 0 1
1 0 0 0 0 0 3 3 3 3 3 3 0 0 0 0 0 0 0 0 0 0 0 0 0 0 0 0 0 0 0 0 0 0 0 0 0 0 4 4 4 4 4 4 0 0 0 0 0 1
1 0 0 0 0 0 3 3 3 3 3 3 0 0 0 0 0 0 0 0 0 0 0 0 0 0 0 0 0 0 0 0 0 0 0 0 0 0 4 4 4 4 4 4 0 0 0 0 0 1
1 0 0 0 0 0 3 3 3 3 3 3 0 0 0 0 1 1 1 1 0 0 0 0 0 0 0 0 0 0 1 1 1 1 0 0 0 0 4 4 4 4 4 4 0 0 0 0 0 1
1 0 0 0 0 0 3 3 3 3 3 3 0 0 0 0 1 D D 2 2 2 2 2 2 2 2 2 2 2 2 D D 1 0 0 0 0 4 4 4 4 4 4 0 0 0 0 0 1
1 0 0 0 0 0 3 3 3 3 3 3 0 0 0 0 1 D 2 2 2 2 2 2 2 2 2 2 2 2 2 2 D 1 0 0 0 0 4 4 4 4 4 4 0 0 0 0 0 1
1 0 0 0 0 1 3 3 3 3 3 3 0 0 0 0 1 2 2 2 2 2 2 2 2 2 2 2 2 2 2 2 2 1 0 0 0 0 4 4 4 4 4 4 1 0 0 0 0 1
1 0 0 0 0 1 3 3 3 3 3 3 0 0 0 0 0 2 2 2 2 1 1 2 2 2 2 1 1 2 2 2 2 0 0 0 0 0 4 4 4 4 4 4 1 0 0 0 0 1
1 0 0 0 1 1 3 3 3 3 3 3 0 0 0 0 0 2 2 2 1 1 D D D D D D 1 1 2 2 2 0 0 0 0 0 4 4 4 4 4 4 1 1 0 0 0 1
1 0 D D 1 1 3 3 3 3 3 3 0 0 0 0 0 2 2 2 1 D D D D D D D D 1 2 2 2 0 0 0 0 0 4 4 4 4 4 4 1 1 D D 0 1
1 0 D 1 1 1 3 3 3 3 3 3 0 0 0 0 0 2 2 2 2 D D D D D D D D 2 2 2 2 0 0 0 0 0 4 4 4 4 4 4 1 1 1 D 0 1
1 1 1 1 1 1 3 3 3 3 3 3 0 0 0 0 0 2 2 2 2 D D D 1 1 D D D 2 2 2 2 0 0 0 0 0 4 4 4 4 4 4 1 1 1 1 1 1
1 1 1 1 1 1 3 3 3 3 3 3 0 0 0 0 0 2 2 2 2 D D D 1 1 D D D 2 2 2 2 0 0 0 0 0 4 4 4 4 4 4 1 1 1 1 1 1
1 0 D 1 1 1 3 3 3 3 3 3 0 0 0 0 0 2 2 2 2 D D D D D D D D 2 2 2 2 0 0 0 0 0 4 4 4 4 4 4 1 1 1 D 0 1
1 0 D D 1 1 3 3 3 3 3 3 0 0 0 0 0 2 2 2 1 D D D D D D D D 1 2 2 2 0 0 0 0 0 4 4 4 4 4 4 1 1 D D 0 1
1 0 0 0 1 1 3 3 3 3 3 3 0 0 0 0 0 2 2 2 1 1 D D D D D D 1 1 2 2 2 0 0 0 0 0 4 4 4 4 4 4 1 1 0 0 0 1
1 0 0 0 0 1 3 3 3 3 3 3 0 0 0 0 0 2 2 2 2 1 1 2 2 2 2 1 1 2 2 2 2 0 0 0 0 0 4 4 4 4 4 4 1 0 0 0 0 1
1 0 0 0 0 1 3 3 3 3 3 3 0 0 0 0 1 2 2 2 2 2 2 2 2 2 2 2 2 2 2 2 2 1 0 0 0 0 4 4 4 4 4 4 1 0 0 0 0 1
1 0 0 0 0 0 3 3 3 3 3 3 0 0 0 0 1 D 2 2 2 2 2 2 2 2 2 2 2 2 2 2 D 1 0 0 0 0 4 4 4 4 4 4 0 0 0 0 0 1
1 0 0 0 0 0 3 3 3 3 3 3 0 0 0 0 1 D D 2 2 2 2 2 2 2 2 2 2 2 2 D D 1 0 0 0 0 4 4 4 4 4 4 0 0 0 0 0 1
1 0 0 0 0 0 3 3 3 3 3 3 0 0 0 0 1 1 1 1 0 0 0 0 0 0 0 0 0 0 1 1 1 1 0 0 0 0 4 4 4 4 4 4 0 0 0 0 0 1
1 0 0 0 0 0 3 3 3 3 3 3 0 0 0 0 0 0 0 0 0 0 0 0 0 0 0 0 0 0 0 0 0 0 0 0 0 0 4 4 4 4 4 4 0 0 0 0 0 1
1 0 0 0 0 0 3 3 3 3 3 3 0 0 0 0 0 0 0 0 0 0 0 0 0 0 0 0 0 0 0 0 0 0 0 0 0 0 4 4 4 4 4 4 0 0 0 0 0 1
1 0 0 0 0 0 3 3 3 3 3 3 3 0 0 0 0 0 0 0 0 0 0 0 0 0 0 0 0 0 0 0 0 0 0 0 0 4 4 4 4 4 4 4 0 0 0 0 0 1
1 0 0 0 0 0 0 3 3 3 3 3 3 3 0 0 0 0 0 0 0 0 0 0 0 0 0 0 0 0 0 0 0 0 0 0 4 4 4 4 4 4 4 0 0 0 0 0 0 1
1 0 0 0 0 0 0 0 3 3 3 3 3 3 3 0 0 0 0 0 0 0 0 1 0 0 1 0 0 0 0 0 0 0 0 4 4 4 4 4 4 4 0 0 0 0 0 0 0 1
1 0 0 0 0 0 0 1 1 1 1 3 3 3 3 3 3 0 0 0 0 0 1 1 0 0 1 1 0 0 0 0 0 4 4 4 4 4 4 1 1 1 1 0 0 0 0 0 0 1
1 0 0 0 0 0 0 0 D D 1 3 3 3 3 3 3 3 0 0 0 1 1 0 D D 0 1 1 0 0 0 4 4 4 4 4 4 4 1 D D 0 0 0 0 0 0 0 1
1 0 0 0 0 0 0 0 D D 1 0 0 3 3 3 3 3 3 3 3 1 0 D D D D 0 1 4 4 4 4 4 4 4 4 0 0 1 D D 0 0 0 0 0 0 0 1
1 0 0 0 0 0 0 0 0 0 1 0 0 0 0 3 3 3 3 3 3 1 0 D D D D 0 1 4 4 4 4 4 4 0 0 0 0 1 0 0 0 0 0 0 0 0 0 1
1 0 0 9 0 0 0 0 0 0 0 0 0 0 0 0 0 0 0 0 0 1 1 0 D D 0 1 1 0 0 0 0 0 0 0 0 0 0 0 0 0 0 0 0 0 C 0 0 1
1 0 0 0 0 0 0 0 0 0 0 0 0 0 0 0 0 0 0 0 0 0 1 1 0 0 1 1 0 0 0 0 0 0 0 0 0 0 0 0 0 0 0 0 0 0 0 0 0 1
1 0 0 0 0 0 0 0 0 0 0 0 0 0 0 0 0 0 0 0 0 0 0 1 1 1 1 0 0 0 0 0 0 0 0 0 0 0 0 0 0 0 0 0 0 0 0 0 0 1
1 0 0 0 0 0 A 0 0 0 0 0 0 0 0 0 0 0 0 0 0 0 0 0 0 0 0 0 0 0 0 0 0 0 0 0 0 0 0 0 0 0 0 B 0 0 0 0 0 1
1 0 0 0 0 0 0 0 0 0 0 0 0 0 0 0 0 0 0 0 0 0 0 0 0 0 0 0 0 0 0 0 0 0 0 0 0 0 0 0 0 0 0 0 0 0 0 0 0 1
1 0 0 0 0 0 0 0 0 0 0 0 0 0 0 0 0 0 0 0 0 0 0 0 0 0 0 0 0 0 0 0 0 0 0 0 0 0 0 0 0 0 0 0 0 0 0 0 0 1
1 1 1 1 1 1 1 1 1 1 1 1 1 1 1 1 1 1 1 1 1 1 1 1 1 1 1 1 1 1 1 1 1 1 1 1 1 1 1 1 1 1 1 1 1 1 1 1 1 1